
1111111111111111111111111111111111111111111111111111111
1000000000000000000000000000000000000000000000000000001
1000000000500000000000000000000000000000000000000000001
1000000000000000000000000100010000000000000000000000001
1000000000000000000000000100010000000000000000000000001
1000000000000000000000000104010000000000000000000000001
1000000000000000000000000100010000000050000000000000001
1000000022222222222222227100017000000000000000000000001
1000000021111111111111111100011111111111111111000000001
1000000021333333333333333333333333333333333331000000001
1000000021322222222222222222222222222222222231000000001
1000000021320000000000000000000000000000000231000000001
1000000021320000000000000000000000000000000231000000001
1000000021320000000000000000000000000000000231000000001
1000000021320000000000000000000000000000050231000000001
1000111111320000000000005000000000000000000231111110001
1000222222320000000000060006000600000000000232222220001
1000111111320000000000000000005000000000000231111110001
1000000001320000000000000000000000000000000231200000001
1000000001320005000000000000000000000000000231200000001
1000000001320000000000000000000000000000000231200000001
1000000001320000000000000000000000000000000231200000001
1000000001322222222222222222222222222222222231200000001
1200000001333333333333333333333333333333333331200000001
1200000001111111111111111100011111111111111111200000001
1200000000000000000500000100017222222222222222200000001
1200000000000000000000000100010000000500000000000000001
1722222000000000000000000000000000000000000000000000001
1111111111111111111111111111111111111111111111111111111