
0000000000500000000000000033333333333333333333333333333
0000000000000000000000000003333333333333333333333333333
1111011111111111111111110001333333333333333333331333133
1111700000000000111111114000163333333333333333331333133
1111111111111110111111110000011111111111111111111333111
0000000000000000000000000000000000000000000000500000000
0000000000000000000000000000000000000000000000000000000
0000500000000000000000000000000000000000000000000000000
0000000000000000000000000000000000000000000000000000000
1111111111000111111111111111111111111111111110001111111
1111111111000111111111111111111111111111111110001111111
1111111111100011111700000000000000071111111100011111111
1111111111110001111111111100111111111111111000111111111
1600000000000000111111111150111111111111110000000000001
1111111111011111111111111100111111111111111111110111111
1111111111000000000000000000000000000000000000000111111
0011000000000000222222222222222222222222200000000001160
0011000000500002222222222222222222222222220000000001100
0000000000000022222222222222222222222222222000000050000
1111111110000002222222222222222222222222220000111111111
0000000000000000222222222222222222222222200000000000000
0000000000000000000000000000000000000000000000000000000
0000000000005000000000000000000000000000000000000000000
0000000000000000000000000000000000000000000000000000000
1111111111333111111111111111111111111111111110001111111
3333333371333133333333333310000000000000000000000000000
3333333331333133333333333331000000000000050000000000000
3333333333333333333333333333000000000000000000000000000
3333333333333333333333333333300000000000000000000000000