
1111111111111111111111111111111111111111111111111111111
1050000000000000000000000000000000000000000000000000271
1000000000000000000000000000000000000000000000000000221
1000011111111111111111111111111111100000000000000000221
1000000000000000000000000000000000000000000500000000221
1000011111111111104111111111111111100000000000000000221
1000011111111111100111111111111111100000000000000000221
1000011117222222100122000000000000000000000000000000221
1000011112222222100122000000000000000000000000000000221
1000011110000000100122000000033333333300000000000000221
1000011110000000100162000000033333333300000000000000221
1000011110000000100111111111133333333300000000000050001
1000011110000000100000000000033333333300000000000000001
1000011110000000100111111111133333333300000000000000001
1000011110000000100100000000033333333300000000000000001
1000000000000000100100000000033333333300000000000000001
1000000000000000100100000000000010100000000000000000001
1000000000000000100100000000000010100000000000000000001
1000000000000000100100000000500010100000000000000000001
1000000000000000100100000000000010100000000000000000001
1000000000000000000000000000000000000000000000000000501
1000000000000000000000000000000000000000000000000000001
1000011111111110000000000000000000000000100000000010001
1000022222222210000000000000000000000000100000000010001
1000022222222610000000000000000000000000100000000010001
1000011111111110000000000000000000000000100000000010001
1000000000000000000000000000000000000000122222222210001
1000000500000000000000000000000000000000172222222610001
1111111111111111111111111111111111111111111111111111111