
0000000500000000000000000000000000000000000000000000000
0222222222222222222222222222222222222222222222222222220
0222222222222222222222222222222222222222222222222222220
0222111111111111111111111111111111111111111111111112220
0222111111111111111111111111111111111111000611111112220
0222163333330050111111111111111111111111000011111112220
0222133333330000000000001111111100000005000011111112220
0222133333330000000000001111111100000000000011111112220
0222133333330000111111001111111100001111111111111112220
0222133333330000111111001111111100001111111111111112220
0222111111110000111111000000000000000000000000011112220
0222111111110000111111000000000005000000000000011112220
0222111111110000111111001111111100001111111111111112220
0222000000000000100000000000000100001111111111111112220
0222040000000000170000500000000100000000000000000002220
0222111111110000111111000000000100000000000000005002220
0222111111110000111111000000000111111111111111111112220
0222111111110000111111000000000000000000000000000012220
0222100000000000111111000000000000000000000000000012220
0222100050000000111111111111000111111111111111105012220
0222111111110000111111111111050111111111111111100012220
0222111111110000111111111111000111111111111111100012220
0222111111110000000011000000000000000113333333300012220
0222111111110000000611000000000000000113333333300012220
0222111111111111111111000000000000000113333333300712220
0227111111111111111111111111000111111111111111111112220
0222222222222222222222222222222222222222222222222222220
0222222222222222222222222222222222222222222222222222220
0000000000000000000000000000000000000000000005000000000