
2222221111111111111111111111111111111111111111111000000
2333321622100000000000000000000071333333333333331000000
2333321222100400000000000011111111111111111100111000000
2333321000111111111111100010000500000000000000000000007
2333321050100000000000100011111111001111111100000011111
2222221000100000000000100000000000000000000100000005000
1110011000100500000000111111111111111111000100000000000
1000000000100000000000000000000000000001000101001011111
1001111111100001000100000001000011111111050101001016222
1001111111100001000100000001000000000000000101001012222
1001000000111111000111111111111111111111111101001011112
1001000000000000000000000000000000000000000001001000012
1001000000000000000000000000000000000000000001001111012
1501000000111111111111111100011111111111111111000001012
1001000000000010000000000100010000000000000000000001022
1001700000000010000000000100010000000000000000000001022
1001111111111111111001111100011110000500000000000001012
1000000000000000000000000000000010000000000000000000017
1000000000000050000000000000000010000000001000010001111
1111111111111111111001111111111110000000010000100000000
0000010001222000000001000000000000000000100001000000000
0000010001111000000001000000000000111111000011111100000
0000010000000000000001000000000000122000000000022100000
0000010000000000000001000000000000122000000000022100500
1013311111111111000001000000000000122000000000022100000
1013333333333361000001700000000000111111000011111100000
1011111111111111110111111110000000000000000000000000001
1000000000000000000000000000000050000000000000000000061
1111111111111111111111111111111111111111111111111111111